arh=Архангельск
bel=Белгород
bry=Брянск
vlu=Великие Луки
vel=Великий Новгород
vla=Владимир
vlg=Волгоград
vol=Вологда
vor=Воронеж
vib=Выборг
gat=Гатчина
eka=Екатринбург
iva=Иваново
ije=Ижевск
ima=Иматра
kaz=Казань
kal=Калуга
kie=Киев
kol=Коломна
kos=Кострома
kot=Котка
kra=Краснодар
kud=Кудымкар
kur=Курск
lap=Лаппеенранта
lug=Луга
lub=Люберцы
min=Минск
mos=Москва
nab=Набережные Челны
nij=Нижний Новгород
ore=Орел
pen=Пенза
per=Пермь
pod=Подольск
psk=Псков
rzv=Ржев
ros=Ростов-на-Дону
rya=Рязань
sam=Самара
spb=Санкт-Петербург
srn=Саранск
sar=Саратов
ser=Серпухов
ses=Сестрорецк
smo=Смоленск
tam=Тамбов
tve=Тверь
tol=Тольятти
tul=Тула
ufa=Уфа
hel=Хельсинки
chb=Чебоксары
chl=Челябинск
che=Череповец
yar=Ярославль
